11111111111
101000001C1
10001010101
10P1001C001
11110111111
100001000E1
10110101111
10110100001
10C10110111
100100000C1
11111111111