11111111111
100001000E1
10110100011
10110100001
1001011P011
100100000C1
11111111111