11111111111
100001000E1
1011010C011
10110100001
1001011P011
10010001011
11111111111