1111111
1P010E1
1000001
1111111