11111111111
1P0000C00E1
11111111111