111111111
1P00000E1
100111001
1000C0001
100000001
111111111