11111111111
10001001001
10101100011
11100001101
10110010011
10011000011
11001C11111
11101001E01
1P000000001
11111111111