11111111111
10001001001
10101100011
11100001101
10110010011
10011000011
11001C11111
11101001001
1P0000000E1
11111111111