1111111
1P01001
1C000E1
1111111